111111111111111111111
1C11000111011111111C1
100001000000000000001
111111110101111110111
1P0000000100030000001
1111111110011101111C1
111111110011110111111
110001110111110111111
1E0100000000C100000C1
111111111111111111111
