111111111111111111111
1P0000000000000000001
101110111010111011101
101100001011111000101
101111111111101111111
1000000C0000000011111
101111111111110111011
100000000111000000001
101101111101111110111
1011001E0000000000001
111111111111111111111