111111111111111111111
1C11000111111111111C1
100001003000000000001
111111110111111011111
1P0000000110000300011
1111111110001111010C1
11111111001111C101111
1100011101111101011C1
1E0100003000C10030001
111111111111111111111
